--#----#######------
----##-##--------##-
----##-#---------##-
--#----#---###------
--##--##----##------
-------##----#------
--------##---###--##
-------------##----#
##--##------###-##-#
#----#--------#-##-#
#-##-#--------#----#
#-##-###------##--##
#----##-------------
##--###---##--------
------#----##-------
------##----##--##--
------###---#----#--
-##---------#-##----
-##--------##-##----
------#######----#--
